10 25
|-----------------------|
|FFF|....|.........F|...|
|........|....|---|.....|
|FF...@|......|...|-..-.|
|.|F...|P.|.............|
|....|......|.|..F......|
|..|F...|.....|-----..-.|
|.....|...P...|P........|
|.|...|..|........|.....|
|-----------------------|